//MAP CONVERTED BY dmm2tgm.py THIS HEADER COMMENT PREVENTS RECONVERSION, DO NOT REMOVE
"a" = (
/obj/machinery/door/firedoor,
/turf/open/floor/catwalk_floor/titanium,
/area/shuttle/mining)
"c" = (
/obj/structure/chair/comfy/shuttle{
	dir = 1
	},
/obj/effect/turf_decal/tile/brown/opposingcorners{
	dir = 4
	},
/turf/open/floor/mineral/titanium/tiled,
/area/shuttle/mining)
"d" = (
/obj/structure/shuttle/engine/propulsion/left,
/obj/effect/turf_decal/stripes/line{
	dir = 10
	},
/turf/open/floor/plating,
/area/shuttle/mining)
"e" = (
/obj/structure/window/reinforced/survival_pod,
/obj/effect/turf_decal/delivery,
/obj/effect/turf_decal/stripes/line,
/obj/structure/ore_box,
/turf/open/floor/mineral/titanium,
/area/shuttle/mining)
"g" = (
/obj/structure/chair/comfy/shuttle{
	dir = 1
	},
/obj/effect/turf_decal/tile/purple/opposingcorners{
	dir = 1
	},
/turf/open/floor/mineral/titanium/tiled,
/area/shuttle/mining)
"h" = (
/obj/docking_port/mobile{
	dwidth = 4;
	height = 6;
	id = "mining";
	name = "salvage shuttle";
	port_direction = 4;
	width = 6;
	dir = 8;
	dheight = 1
	},
/turf/closed/wall/mineral/titanium/nodiagonal,
/area/shuttle/mining)
"l" = (
/obj/structure/shuttle/engine/heater,
/obj/structure/window/reinforced/survival_pod{
	dir = 1
	},
/obj/effect/turf_decal/stripes/line{
	dir = 1
	},
/obj/effect/turf_decal/stripes/corner,
/turf/open/floor/plating,
/area/shuttle/mining)
"n" = (
/obj/effect/turf_decal/siding/thinplating_new{
	dir = 1
	},
/turf/open/floor/mineral/titanium,
/area/shuttle/mining)
"p" = (
/obj/machinery/computer/shuttle/salvage,
/obj/effect/turf_decal/tile/brown/half/contrasted{
	dir = 1
	},
/obj/effect/turf_decal/siding/thinplating_new,
/turf/open/floor/mineral/titanium/tiled,
/area/shuttle/mining)
"q" = (
/obj/structure/shuttle/engine/heater,
/obj/structure/window/reinforced/survival_pod{
	dir = 1
	},
/obj/effect/turf_decal/stripes/line{
	dir = 1
	},
/obj/effect/turf_decal/stripes/corner{
	dir = 8
	},
/turf/open/floor/plating,
/area/shuttle/mining)
"s" = (
/turf/template_noop,
/area/template_noop)
"t" = (
/obj/structure/table/reinforced,
/obj/effect/turf_decal/tile/brown/opposingcorners{
	dir = 1
	},
/obj/effect/turf_decal/siding/thinplating_new,
/obj/item/wrench,
/obj/item/crowbar/red,
/obj/item/tank/internals/emergency_oxygen,
/obj/item/clothing/mask/gas,
/turf/open/floor/mineral/titanium/tiled,
/area/shuttle/mining)
"u" = (
/obj/machinery/door/airlock/external,
/obj/effect/turf_decal/stripes/line{
	dir = 4
	},
/obj/effect/mapping_helpers/airlock/cyclelink_helper{
	dir = 8
	},
/turf/open/floor/plating,
/area/shuttle/mining)
"w" = (
/obj/effect/turf_decal/siding/thinplating_new/corner{
	dir = 4
	},
/turf/open/floor/mineral/titanium,
/area/shuttle/mining)
"A" = (
/obj/machinery/suit_storage_unit/mining/eva,
/obj/effect/turf_decal/stripes/line{
	dir = 4
	},
/obj/effect/turf_decal/stripes/red/line{
	dir = 4
	},
/obj/effect/turf_decal/siding/wideplating_new{
	dir = 8
	},
/turf/open/floor/iron/textured_large,
/area/shuttle/mining)
"B" = (
/obj/effect/spawner/structure/window/reinforced/shuttle,
/turf/open/floor/plating,
/area/shuttle/mining)
"D" = (
/obj/structure/tank_dispenser/oxygen,
/obj/effect/turf_decal/stripes/line{
	dir = 8
	},
/obj/effect/turf_decal/stripes/white/line{
	dir = 8
	},
/obj/effect/turf_decal/siding/wideplating_new{
	dir = 4
	},
/turf/open/floor/iron/textured_large,
/area/shuttle/mining)
"F" = (
/turf/closed/wall/mineral/titanium/nodiagonal,
/area/shuttle/mining)
"G" = (
/obj/effect/turf_decal/siding/thinplating_new/corner{
	dir = 1
	},
/obj/machinery/firealarm/directional/south,
/turf/open/floor/mineral/titanium,
/area/shuttle/mining)
"I" = (
/obj/structure/window/reinforced/survival_pod,
/obj/effect/turf_decal/delivery,
/obj/effect/turf_decal/stripes/line,
/obj/structure/rack/shelf,
/obj/item/shovel,
/obj/item/shovel,
/obj/item/shovel,
/obj/item/shovel,
/turf/open/floor/mineral/titanium,
/area/shuttle/mining)
"K" = (
/turf/closed/wall/mineral/titanium/survival/nodiagonal,
/area/shuttle/mining)
"M" = (
/obj/effect/turf_decal/siding/thinplating_new{
	dir = 8
	},
/turf/open/floor/mineral/titanium,
/area/shuttle/mining)
"N" = (
/obj/structure/shuttle/engine/propulsion/right,
/obj/effect/turf_decal/stripes/line{
	dir = 6
	},
/turf/open/floor/plating,
/area/shuttle/mining)
"O" = (
/obj/machinery/modular_computer/console/preset/civilian,
/obj/effect/turf_decal/tile/brown/half/contrasted{
	dir = 1
	},
/obj/effect/turf_decal/siding/thinplating_new,
/turf/open/floor/mineral/titanium/tiled,
/area/shuttle/mining)
"P" = (
/obj/machinery/door/airlock/external,
/obj/effect/turf_decal/stripes/line{
	dir = 8
	},
/obj/effect/mapping_helpers/airlock/cyclelink_helper{
	dir = 4
	},
/turf/open/floor/plating,
/area/shuttle/mining)
"Q" = (
/obj/effect/turf_decal/siding/thinplating_new{
	dir = 4
	},
/obj/machinery/light/directional/west,
/turf/open/floor/mineral/titanium,
/area/shuttle/mining)
"R" = (
/turf/open/floor/mineral/titanium,
/area/shuttle/mining)
"S" = (
/obj/machinery/light/small/directional/north,
/turf/open/floor/plating,
/area/shuttle/mining)
"U" = (
/obj/structure/shuttle/engine/propulsion,
/turf/open/floor/plating,
/area/shuttle/mining)
"V" = (
/obj/structure/table/reinforced,
/obj/item/storage/toolbox/emergency,
/obj/effect/turf_decal/tile/brown/opposingcorners,
/obj/effect/turf_decal/siding/thinplating_new,
/turf/open/floor/mineral/titanium/tiled,
/area/shuttle/mining)
"W" = (
/obj/effect/turf_decal/siding/thinplating_new{
	dir = 4
	},
/turf/open/floor/mineral/titanium,
/area/shuttle/mining)
"X" = (
/obj/structure/chair/sofa/bench/right,
/obj/effect/turf_decal/tile/purple/opposingcorners{
	dir = 1
	},
/turf/open/floor/mineral/titanium/tiled,
/area/shuttle/mining)
"Y" = (
/obj/effect/turf_decal/tile/brown/opposingcorners{
	dir = 4
	},
/obj/structure/chair/sofa/bench/left,
/turf/open/floor/mineral/titanium/tiled,
/area/shuttle/mining)

(1,1,1) = {"
s
F
B
F
s
F
P
K
s
"}
(2,1,1) = {"
F
F
A
F
F
F
S
q
d
"}
(3,1,1) = {"
B
V
W
Q
w
F
u
K
K
"}
(4,1,1) = {"
B
p
c
X
n
a
R
I
U
"}
(5,1,1) = {"
B
O
g
Y
n
a
R
e
U
"}
(6,1,1) = {"
B
t
M
M
G
F
P
K
K
"}
(7,1,1) = {"
F
F
D
F
h
F
S
l
N
"}
(8,1,1) = {"
s
F
B
F
s
F
u
K
s
"}
